"filename", "language", "vue", "HTML", "YAML", "Rust", "TOML", "comment", "blank", "total"
"/home/jcfun/learning/Project/e-tech-assist/web-client/admin/index.html", "HTML", 0, 28, 0, 0, 0, 0, 3, 31
"/home/jcfun/learning/Project/e-tech-assist/web-client/admin/pnpm-lock.yaml", "YAML", 0, 0, 3741, 0, 0, 0, 549, 4290
"/home/jcfun/learning/Project/e-tech-assist/web-client/admin/src/App.vue", "vue", 3, 0, 0, 0, 0, 0, 1, 4
"/home/jcfun/learning/Project/e-tech-assist/web-client/admin/src/components/AddButton.vue", "vue", 23, 0, 0, 0, 0, 0, 3, 26
"/home/jcfun/learning/Project/e-tech-assist/web-client/admin/src/components/DeleteButton.vue", "vue", 23, 0, 0, 0, 0, 0, 3, 26
"/home/jcfun/learning/Project/e-tech-assist/web-client/admin/src/components/IconSelector.vue", "vue", 134, 0, 0, 0, 0, 0, 2, 136
"/home/jcfun/learning/Project/e-tech-assist/web-client/admin/src/components/MarkdownEditor.vue", "vue", 5, 0, 0, 0, 0, 0, 3, 8
"/home/jcfun/learning/Project/e-tech-assist/web-client/admin/src/components/MessageContent.vue", "vue", 75, 0, 0, 0, 0, 0, 3, 78
"/home/jcfun/learning/Project/e-tech-assist/web-client/admin/src/components/ModalDialog.vue", "vue", 65, 0, 0, 0, 0, 0, 3, 68
"/home/jcfun/learning/Project/e-tech-assist/web-client/admin/src/components/PasswordStrong.vue", "vue", 86, 0, 0, 0, 0, 0, 8, 94
"/home/jcfun/learning/Project/e-tech-assist/web-client/admin/src/components/RichTextEditor.vue", "vue", 54, 0, 0, 0, 0, 0, 7, 61
"/home/jcfun/learning/Project/e-tech-assist/web-client/admin/src/components/Scrollbar/src/Scrollbar.vue", "vue", 172, 0, 0, 0, 0, 0, 23, 195
"/home/jcfun/learning/Project/e-tech-assist/web-client/admin/src/components/SearchContent.vue", "vue", 100, 0, 0, 0, 0, 0, 3, 103
"/home/jcfun/learning/Project/e-tech-assist/web-client/admin/src/components/SortableTable.vue", "vue", 126, 0, 0, 0, 0, 0, 3, 129
"/home/jcfun/learning/Project/e-tech-assist/web-client/admin/src/components/TableBody.vue", "vue", 14, 0, 0, 0, 0, 0, 2, 16
"/home/jcfun/learning/Project/e-tech-assist/web-client/admin/src/components/TableConfig.vue", "vue", 46, 0, 0, 0, 0, 0, 3, 49
"/home/jcfun/learning/Project/e-tech-assist/web-client/admin/src/components/TableFooter.vue", "vue", 86, 0, 0, 0, 0, 0, 3, 89
"/home/jcfun/learning/Project/e-tech-assist/web-client/admin/src/components/TableHeader.vue", "vue", 72, 0, 0, 0, 0, 0, 3, 75
"/home/jcfun/learning/Project/e-tech-assist/web-client/admin/src/layout/Layout.vue", "vue", 129, 0, 0, 0, 0, 0, 3, 132
"/home/jcfun/learning/Project/e-tech-assist/web-client/admin/src/layout/Main.vue", "vue", 28, 0, 0, 0, 0, 0, 3, 31
"/home/jcfun/learning/Project/e-tech-assist/web-client/admin/src/layout/MainLayout.vue", "vue", 158, 0, 0, 0, 0, 0, 8, 166
"/home/jcfun/learning/Project/e-tech-assist/web-client/admin/src/layout/actions/index.vue", "vue", 118, 0, 0, 0, 0, 0, 3, 121
"/home/jcfun/learning/Project/e-tech-assist/web-client/admin/src/layout/avatar/index.vue", "vue", 119, 0, 0, 0, 0, 0, 4, 123
"/home/jcfun/learning/Project/e-tech-assist/web-client/admin/src/layout/breadcrumb/index.vue", "vue", 99, 0, 0, 0, 0, 0, 2, 101
"/home/jcfun/learning/Project/e-tech-assist/web-client/admin/src/layout/footer/index.vue", "vue", 24, 0, 0, 0, 0, 0, 4, 28
"/home/jcfun/learning/Project/e-tech-assist/web-client/admin/src/layout/header/index.vue", "vue", 96, 0, 0, 0, 0, 0, 3, 99
"/home/jcfun/learning/Project/e-tech-assist/web-client/admin/src/layout/humburger/index.vue", "vue", 45, 0, 0, 0, 0, 0, 3, 48
"/home/jcfun/learning/Project/e-tech-assist/web-client/admin/src/layout/loading/index.vue", "vue", 19, 0, 0, 0, 0, 0, 4, 23
"/home/jcfun/learning/Project/e-tech-assist/web-client/admin/src/layout/logo/index.vue", "vue", 81, 0, 0, 0, 0, 0, 2, 83
"/home/jcfun/learning/Project/e-tech-assist/web-client/admin/src/layout/navbar/index.vue", "vue", 47, 0, 0, 0, 0, 0, 3, 50
"/home/jcfun/learning/Project/e-tech-assist/web-client/admin/src/layout/setting/components/StyleExample.vue", "vue", 115, 0, 0, 0, 0, 0, 4, 119
"/home/jcfun/learning/Project/e-tech-assist/web-client/admin/src/layout/setting/index.vue", "vue", 419, 0, 0, 0, 0, 0, 10, 429
"/home/jcfun/learning/Project/e-tech-assist/web-client/admin/src/layout/sidebar/InnerSideBar.vue", "vue", 231, 0, 0, 0, 0, 0, 3, 234
"/home/jcfun/learning/Project/e-tech-assist/web-client/admin/src/layout/sidebar/SideBar.vue", "vue", 209, 0, 0, 0, 0, 0, 4, 213
"/home/jcfun/learning/Project/e-tech-assist/web-client/admin/src/layout/sidebar/TabSplitSideBar.vue", "vue", 297, 0, 0, 0, 0, 0, 4, 301
"/home/jcfun/learning/Project/e-tech-assist/web-client/admin/src/layout/sidebar/components/ScrollerMenu.vue", "vue", 161, 0, 0, 0, 0, 0, 4, 165
"/home/jcfun/learning/Project/e-tech-assist/web-client/admin/src/layout/sidebar/components/SubMenu.vue", "vue", 41, 0, 0, 0, 0, 0, 3, 44
"/home/jcfun/learning/Project/e-tech-assist/web-client/admin/src/layout/tabbar/index.vue", "vue", 364, 0, 0, 0, 0, 0, 5, 369
"/home/jcfun/learning/Project/e-tech-assist/web-client/admin/src/views/data/article.vue", "vue", 391, 0, 0, 0, 0, 0, 5, 396
"/home/jcfun/learning/Project/e-tech-assist/web-client/admin/src/views/data/quick-msg.vue", "vue", 391, 0, 0, 0, 0, 0, 5, 396
"/home/jcfun/learning/Project/e-tech-assist/web-client/admin/src/views/index/components/CenterTitle.vue", "vue", 64, 0, 0, 0, 0, 0, 2, 66
"/home/jcfun/learning/Project/e-tech-assist/web-client/admin/src/views/index/components/DataItem.vue", "vue", 81, 0, 0, 0, 0, 0, 4, 85
"/home/jcfun/learning/Project/e-tech-assist/web-client/admin/src/views/index/components/ProjectItem.vue", "vue", 95, 0, 0, 0, 0, 0, 4, 99
"/home/jcfun/learning/Project/e-tech-assist/web-client/admin/src/views/index/components/ProjectList.vue", "vue", 66, 0, 0, 0, 0, 0, 4, 70
"/home/jcfun/learning/Project/e-tech-assist/web-client/admin/src/views/index/components/SaleOrderList.vue", "vue", 121, 0, 0, 0, 0, 0, 5, 126
"/home/jcfun/learning/Project/e-tech-assist/web-client/admin/src/views/index/components/TodoItem.vue", "vue", 59, 0, 0, 0, 0, 0, 4, 63
"/home/jcfun/learning/Project/e-tech-assist/web-client/admin/src/views/index/components/chart/DepartmentChart.vue", "vue", 99, 0, 0, 0, 0, 0, 3, 102
"/home/jcfun/learning/Project/e-tech-assist/web-client/admin/src/views/index/components/chart/EnrollmentChannelsChart.vue", "vue", 114, 0, 0, 0, 0, 0, 3, 117
"/home/jcfun/learning/Project/e-tech-assist/web-client/admin/src/views/index/components/chart/FullYearSalesChart.vue", "vue", 120, 0, 0, 0, 0, 0, 3, 123
"/home/jcfun/learning/Project/e-tech-assist/web-client/admin/src/views/index/components/chart/HotProductChart.vue", "vue", 105, 0, 0, 0, 0, 0, 3, 108
"/home/jcfun/learning/Project/e-tech-assist/web-client/admin/src/views/index/components/chart/OrderChart.vue", "vue", 108, 0, 0, 0, 0, 0, 3, 111
"/home/jcfun/learning/Project/e-tech-assist/web-client/admin/src/views/index/components/chart/SalesChart.vue", "vue", 105, 0, 0, 0, 0, 0, 3, 108
"/home/jcfun/learning/Project/e-tech-assist/web-client/admin/src/views/index/components/chart/WeekSalesChart.vue", "vue", 123, 0, 0, 0, 0, 0, 3, 126
"/home/jcfun/learning/Project/e-tech-assist/web-client/admin/src/views/index/index.vue", "vue", 173, 0, 0, 0, 0, 0, 5, 178
"/home/jcfun/learning/Project/e-tech-assist/web-client/admin/src/views/index/personal/index.vue", "vue", 266, 0, 0, 0, 0, 0, 3, 269
"/home/jcfun/learning/Project/e-tech-assist/web-client/admin/src/views/login/index.vue", "vue", 226, 0, 0, 0, 0, 0, 5, 231
"/home/jcfun/learning/Project/e-tech-assist/web-client/admin/src/views/monitor/login-log.vue", "vue", 241, 0, 0, 0, 0, 0, 5, 246
"/home/jcfun/learning/Project/e-tech-assist/web-client/admin/src/views/redirect/index.vue", "vue", 17, 0, 0, 0, 0, 0, 3, 20
"/home/jcfun/learning/Project/e-tech-assist/web-client/admin/src/views/redirect/preload-route.vue", "vue", 29, 0, 0, 0, 0, 0, 4, 33
"/home/jcfun/learning/Project/e-tech-assist/web-client/admin/src/views/system/perm.vue", "vue", 651, 0, 0, 0, 0, 0, 6, 657
"/home/jcfun/learning/Project/e-tech-assist/web-client/admin/src/views/system/role.vue", "vue", 444, 0, 0, 0, 0, 0, 6, 450
"/home/jcfun/learning/Project/e-tech-assist/web-client/admin/src/views/system/user.vue", "vue", 612, 0, 0, 0, 0, 0, 6, 618
"/home/jcfun/learning/Project/e-tech-assist/web-client/mini-program/index.html", "HTML", 0, 24, 0, 0, 0, 0, 2, 26
"/home/jcfun/learning/Project/e-tech-assist/web-client/mini-program/pnpm-lock.yaml", "YAML", 0, 0, 6822, 0, 0, 0, 906, 7728
"/home/jcfun/learning/Project/e-tech-assist/web-client/mini-program/src/App.vue", "vue", 18, 0, 0, 0, 0, 0, 1, 19
"/home/jcfun/learning/Project/e-tech-assist/web-client/mini-program/src/components/mine-func/mine-func.vue", "vue", 37, 0, 0, 0, 0, 0, 4, 41
"/home/jcfun/learning/Project/e-tech-assist/web-client/mini-program/src/components/mine-login/mine-login.vue", "vue", 113, 0, 0, 0, 0, 0, 8, 121
"/home/jcfun/learning/Project/e-tech-assist/web-client/mini-program/src/pages/account/account.vue", "vue", 84, 0, 0, 0, 0, 0, 4, 88
"/home/jcfun/learning/Project/e-tech-assist/web-client/mini-program/src/pages/auth/auth.vue", "vue", 163, 0, 0, 0, 0, 0, 18, 181
"/home/jcfun/learning/Project/e-tech-assist/web-client/mini-program/src/pages/index/index.vue", "vue", 5, 0, 0, 0, 0, 0, 3, 8
"/home/jcfun/learning/Project/e-tech-assist/web-client/mini-program/src/pages/mine/mine.vue", "vue", 9, 0, 0, 0, 0, 0, 3, 12
"/home/jcfun/learning/Project/e-tech-assist/web-client/mini-program/src/pages/more/more.vue", "vue", 91, 0, 0, 0, 0, 0, 5, 96
"/home/jcfun/learning/Project/e-tech-assist/web-client/mini-program/src/pages/msg/msg.vue", "vue", 75, 0, 0, 0, 0, 0, 3, 78
"/home/jcfun/learning/Project/e-tech-assist/web-client/mini-program/src/pages/qrcode/qrcode.vue", "vue", 177, 0, 0, 0, 0, 0, 3, 180
"/home/jcfun/learning/Project/e-tech-assist/web-client/mini-program/src/pages/quick-msg/detail.vue", "vue", 152, 0, 0, 0, 0, 0, 3, 155
"/home/jcfun/learning/Project/e-tech-assist/web-client/mini-program/src/pages/quick-msg/list.vue", "vue", 127, 0, 0, 0, 0, 0, 4, 131
"/home/jcfun/learning/Project/e-tech-assist/web-client/mini-program/src/pages/quick-msg/send.vue", "vue", 174, 0, 0, 0, 0, 0, 5, 179
"/home/jcfun/learning/Project/e-tech-assist/web-client/web/index.html", "HTML", 0, 13, 0, 0, 0, 0, 3, 16
"/home/jcfun/learning/Project/e-tech-assist/web-client/web/pnpm-lock.yaml", "YAML", 0, 0, 3574, 0, 0, 0, 513, 4087
"/home/jcfun/learning/Project/e-tech-assist/web-client/web/src/App.vue", "vue", 3, 0, 0, 0, 0, 0, 1, 4
"/home/jcfun/learning/Project/e-tech-assist/web-client/web/src/components/Captcha.vue", "vue", 59, 0, 0, 0, 0, 0, 3, 62
"/home/jcfun/learning/Project/e-tech-assist/web-client/web/src/components/Content.vue", "vue", 23, 0, 0, 0, 0, 0, 2, 25
"/home/jcfun/learning/Project/e-tech-assist/web-client/web/src/components/Footer.vue", "vue", 106, 0, 0, 0, 0, 0, 2, 108
"/home/jcfun/learning/Project/e-tech-assist/web-client/web/src/components/Header.vue", "vue", 156, 0, 0, 0, 0, 0, 3, 159
"/home/jcfun/learning/Project/e-tech-assist/web-client/web/src/components/Layout.vue", "vue", 11, 0, 0, 0, 0, 0, 3, 14
"/home/jcfun/learning/Project/e-tech-assist/web-client/web/src/components/ScrollToTopButton.vue", "vue", 47, 0, 0, 0, 0, 0, 5, 52
"/home/jcfun/learning/Project/e-tech-assist/web-client/web/src/views/article/detail.vue", "vue", 179, 0, 0, 0, 0, 0, 4, 183
"/home/jcfun/learning/Project/e-tech-assist/web-client/web/src/views/article/index.vue", "vue", 396, 0, 0, 0, 0, 0, 4, 400
"/home/jcfun/learning/Project/e-tech-assist/web-client/web/src/views/create-center/article/edit.vue", "vue", 245, 0, 0, 0, 0, 0, 4, 249
"/home/jcfun/learning/Project/e-tech-assist/web-client/web/src/views/create-center/article/overview.vue", "vue", 177, 0, 0, 0, 0, 0, 3, 180
"/home/jcfun/learning/Project/e-tech-assist/web-client/web/src/views/create-center/article/publish.vue", "vue", 240, 0, 0, 0, 0, 0, 4, 244
"/home/jcfun/learning/Project/e-tech-assist/web-client/web/src/views/create-center/components/SideBar.vue", "vue", 104, 0, 0, 0, 0, 0, 3, 107
"/home/jcfun/learning/Project/e-tech-assist/web-client/web/src/views/create-center/index.vue", "vue", 19, 0, 0, 0, 0, 0, 3, 22
"/home/jcfun/learning/Project/e-tech-assist/web-client/web/src/views/create-center/overview/index.vue", "vue", 164, 0, 0, 0, 0, 0, 3, 167
"/home/jcfun/learning/Project/e-tech-assist/web-client/web/src/views/login/index.vue", "vue", 153, 0, 0, 0, 0, 0, 4, 157
"/home/jcfun/learning/Project/e-tech-assist/web-client/web/src/views/register/index.vue", "vue", 135, 0, 0, 0, 0, 0, 3, 138
"/home/jcfun/learning/Project/e-tech-assist/web-client/web/src/views/reset-pwd/index.vue", "vue", 135, 0, 0, 0, 0, 0, 3, 138
"/home/jcfun/learning/Project/e-tech-assist/web-client/webassembly/.appveyor.yml", "YAML", 0, 0, 9, 0, 0, 0, 3, 12
"/home/jcfun/learning/Project/e-tech-assist/web-client/webassembly/.travis.yml", "YAML", 0, 0, 57, 0, 0, 7, 6, 70
"/home/jcfun/learning/Project/e-tech-assist/web-client/webassembly/Cargo.toml", "TOML", 0, 0, 0, 0, 34, 7, 8, 49
"/home/jcfun/learning/Project/e-tech-assist/web-client/webassembly/src/lib.rs", "Rust", 0, 0, 0, 23, 0, 2, 6, 31
"/home/jcfun/learning/Project/e-tech-assist/web-client/webassembly/src/utils.rs", "Rust", 0, 0, 0, 4, 0, 6, 1, 11
"/home/jcfun/learning/Project/e-tech-assist/web-client/webassembly/tests/web.rs", "Rust", 0, 0, 0, 8, 0, 1, 5, 14
"/home/jcfun/learning/Project/e-tech-assist/web-server/Cargo.toml", "TOML", 0, 0, 0, 0, -100, 0, -26, -126
"/home/jcfun/learning/Project/e-tech-assist/web-server/src/common/banner.rs", "Rust", 0, 0, 0, -12, 0, 0, -2, -14
"/home/jcfun/learning/Project/e-tech-assist/web-server/src/common/errors.rs", "Rust", 0, 0, 0, -189, 0, -9, -16, -214
"/home/jcfun/learning/Project/e-tech-assist/web-server/src/common/mod.rs", "Rust", 0, 0, 0, -3, 0, 0, -1, -4
"/home/jcfun/learning/Project/e-tech-assist/web-server/src/common/res.rs", "Rust", 0, 0, 0, -170, 0, -21, -22, -213
"/home/jcfun/learning/Project/e-tech-assist/web-server/src/config/cfg.rs", "Rust", 0, 0, 0, -88, 0, -29, -12, -129
"/home/jcfun/learning/Project/e-tech-assist/web-server/src/config/ctx.rs", "Rust", 0, 0, 0, -21, 0, 0, -5, -26
"/home/jcfun/learning/Project/e-tech-assist/web-server/src/config/init.rs", "Rust", 0, 0, 0, -14, 0, -2, -6, -22
"/home/jcfun/learning/Project/e-tech-assist/web-server/src/config/mod.rs", "Rust", 0, 0, 0, -3, 0, 0, -1, -4
"/home/jcfun/learning/Project/e-tech-assist/web-server/src/dbaccess/article.rs", "Rust", 0, 0, 0, -246, 0, 0, -12, -258
"/home/jcfun/learning/Project/e-tech-assist/web-server/src/dbaccess/login.rs", "Rust", 0, 0, 0, -211, 0, 0, -13, -224
"/home/jcfun/learning/Project/e-tech-assist/web-server/src/dbaccess/mod.rs", "Rust", 0, 0, 0, -18, 0, 0, -4, -22
"/home/jcfun/learning/Project/e-tech-assist/web-server/src/dbaccess/perm.rs", "Rust", 0, 0, 0, -145, 0, 0, -7, -152
"/home/jcfun/learning/Project/e-tech-assist/web-server/src/dbaccess/quick_msg.rs", "Rust", 0, 0, 0, -261, 0, 0, -9, -270
"/home/jcfun/learning/Project/e-tech-assist/web-server/src/dbaccess/role.rs", "Rust", 0, 0, 0, -226, 0, 0, -12, -238
"/home/jcfun/learning/Project/e-tech-assist/web-server/src/dbaccess/user.rs", "Rust", 0, 0, 0, -294, 0, 0, -17, -311
"/home/jcfun/learning/Project/e-tech-assist/web-server/src/handlers/article.rs", "Rust", 0, 0, 0, -267, 0, -17, -11, -295
"/home/jcfun/learning/Project/e-tech-assist/web-server/src/handlers/login.rs", "Rust", 0, 0, 0, -512, 0, 0, -17, -529
"/home/jcfun/learning/Project/e-tech-assist/web-server/src/handlers/mod.rs", "Rust", 0, 0, 0, -8, 0, 0, -1, -9
"/home/jcfun/learning/Project/e-tech-assist/web-server/src/handlers/perm.rs", "Rust", 0, 0, 0, -190, 0, -22, -8, -220
"/home/jcfun/learning/Project/e-tech-assist/web-server/src/handlers/quick_msg.rs", "Rust", 0, 0, 0, -222, 0, -18, -7, -247
"/home/jcfun/learning/Project/e-tech-assist/web-server/src/handlers/role.rs", "Rust", 0, 0, 0, -188, 0, -22, -8, -218
"/home/jcfun/learning/Project/e-tech-assist/web-server/src/handlers/test.rs", "Rust", 0, 0, 0, -20, 0, 0, -2, -22
"/home/jcfun/learning/Project/e-tech-assist/web-server/src/handlers/upload.rs", "Rust", 0, 0, 0, -60, 0, 0, -3, -63
"/home/jcfun/learning/Project/e-tech-assist/web-server/src/handlers/user.rs", "Rust", 0, 0, 0, -230, 0, -27, -7, -264
"/home/jcfun/learning/Project/e-tech-assist/web-server/src/main.rs", "Rust", 0, 0, 0, -65, 0, 0, -12, -77
"/home/jcfun/learning/Project/e-tech-assist/web-server/src/middleware/auth.rs", "Rust", 0, 0, 0, 0, 0, 0, -2, -2
"/home/jcfun/learning/Project/e-tech-assist/web-server/src/middleware/cors.rs", "Rust", 0, 0, 0, -7, 0, 0, -2, -9
"/home/jcfun/learning/Project/e-tech-assist/web-server/src/middleware/errors.rs", "Rust", 0, 0, 0, -39, 0, 0, -7, -46
"/home/jcfun/learning/Project/e-tech-assist/web-server/src/middleware/filter.rs", "Rust", 0, 0, 0, -66, 0, 0, -6, -72
"/home/jcfun/learning/Project/e-tech-assist/web-server/src/middleware/mod.rs", "Rust", 0, 0, 0, -4, 0, 0, -1, -5
"/home/jcfun/learning/Project/e-tech-assist/web-server/src/models/dto/article.rs", "Rust", 0, 0, 0, -131, 0, 0, -31, -162
"/home/jcfun/learning/Project/e-tech-assist/web-server/src/models/dto/base.rs", "Rust", 0, 0, 0, -30, 0, 0, -9, -39
"/home/jcfun/learning/Project/e-tech-assist/web-server/src/models/dto/login.rs", "Rust", 0, 0, 0, -168, 0, 0, -41, -209
"/home/jcfun/learning/Project/e-tech-assist/web-server/src/models/dto/mod.rs", "Rust", 0, 0, 0, -7, 0, 0, -1, -8
"/home/jcfun/learning/Project/e-tech-assist/web-server/src/models/dto/perm.rs", "Rust", 0, 0, 0, -100, 0, 0, -35, -135
"/home/jcfun/learning/Project/e-tech-assist/web-server/src/models/dto/quick_msg.rs", "Rust", 0, 0, 0, -83, 0, 0, -27, -110
"/home/jcfun/learning/Project/e-tech-assist/web-server/src/models/dto/role.rs", "Rust", 0, 0, 0, -66, 0, 0, -20, -86
"/home/jcfun/learning/Project/e-tech-assist/web-server/src/models/dto/user.rs", "Rust", 0, 0, 0, -96, 0, 0, -30, -126
"/home/jcfun/learning/Project/e-tech-assist/web-server/src/models/entity/base.rs", "Rust", 0, 0, 0, -15, 0, 0, -2, -17
"/home/jcfun/learning/Project/e-tech-assist/web-server/src/models/entity/mod.rs", "Rust", 0, 0, 0, -3, 0, 0, -1, -4
"/home/jcfun/learning/Project/e-tech-assist/web-server/src/models/entity/user.rs", "Rust", 0, 0, 0, -13, 0, 0, -3, -16
"/home/jcfun/learning/Project/e-tech-assist/web-server/src/models/entity/user_detail.rs", "Rust", 0, 0, 0, -20, 0, 0, -3, -23
"/home/jcfun/learning/Project/e-tech-assist/web-server/src/models/enums/article.rs", "Rust", 0, 0, 0, -99, 0, 0, -14, -113
"/home/jcfun/learning/Project/e-tech-assist/web-server/src/models/enums/common.rs", "Rust", 0, 0, 0, -46, 0, 0, -6, -52
"/home/jcfun/learning/Project/e-tech-assist/web-server/src/models/enums/mod.rs", "Rust", 0, 0, 0, -2, 0, 0, 0, -2
"/home/jcfun/learning/Project/e-tech-assist/web-server/src/models/mod.rs", "Rust", 0, 0, 0, -4, 0, 0, -1, -5
"/home/jcfun/learning/Project/e-tech-assist/web-server/src/models/vo/article.rs", "Rust", 0, 0, 0, -43, 0, 0, -3, -46
"/home/jcfun/learning/Project/e-tech-assist/web-server/src/models/vo/login.rs", "Rust", 0, 0, 0, -62, 0, 0, -6, -68
"/home/jcfun/learning/Project/e-tech-assist/web-server/src/models/vo/mod.rs", "Rust", 0, 0, 0, -7, 0, 0, -1, -8
"/home/jcfun/learning/Project/e-tech-assist/web-server/src/models/vo/perm.rs", "Rust", 0, 0, 0, -37, 0, 0, -4, -41
"/home/jcfun/learning/Project/e-tech-assist/web-server/src/models/vo/quick_msg.rs", "Rust", 0, 0, 0, -30, 0, 0, -2, -32
"/home/jcfun/learning/Project/e-tech-assist/web-server/src/models/vo/role.rs", "Rust", 0, 0, 0, -20, 0, 0, -3, -23
"/home/jcfun/learning/Project/e-tech-assist/web-server/src/models/vo/upload.rs", "Rust", 0, 0, 0, -8, 0, 0, -2, -10
"/home/jcfun/learning/Project/e-tech-assist/web-server/src/models/vo/user.rs", "Rust", 0, 0, 0, -32, 0, 0, -3, -35
"/home/jcfun/learning/Project/e-tech-assist/web-server/src/routers/article.rs", "Rust", 0, 0, 0, -14, 0, 0, -1, -15
"/home/jcfun/learning/Project/e-tech-assist/web-server/src/routers/assets.rs", "Rust", 0, 0, 0, -7, 0, 0, -1, -8
"/home/jcfun/learning/Project/e-tech-assist/web-server/src/routers/common.rs", "Rust", 0, 0, 0, -12, 0, 0, -1, -13
"/home/jcfun/learning/Project/e-tech-assist/web-server/src/routers/login.rs", "Rust", 0, 0, 0, -17, 0, 0, -1, -18
"/home/jcfun/learning/Project/e-tech-assist/web-server/src/routers/mod.rs", "Rust", 0, 0, 0, -64, 0, 0, -3, -67
"/home/jcfun/learning/Project/e-tech-assist/web-server/src/routers/perm.rs", "Rust", 0, 0, 0, -14, 0, 0, -1, -15
"/home/jcfun/learning/Project/e-tech-assist/web-server/src/routers/quick_msg.rs", "Rust", 0, 0, 0, -14, 0, 0, -2, -16
"/home/jcfun/learning/Project/e-tech-assist/web-server/src/routers/role.rs", "Rust", 0, 0, 0, -15, 0, 0, -1, -16
"/home/jcfun/learning/Project/e-tech-assist/web-server/src/routers/test.rs", "Rust", 0, 0, 0, -5, 0, 0, -1, -6
"/home/jcfun/learning/Project/e-tech-assist/web-server/src/routers/upload.rs", "Rust", 0, 0, 0, -8, 0, 0, -2, -10
"/home/jcfun/learning/Project/e-tech-assist/web-server/src/routers/user.rs", "Rust", 0, 0, 0, -14, 0, 0, -1, -15
"/home/jcfun/learning/Project/e-tech-assist/web-server/src/utils/captcha.rs", "Rust", 0, 0, 0, -25, 0, -1, -4, -30
"/home/jcfun/learning/Project/e-tech-assist/web-server/src/utils/db.rs", "Rust", 0, 0, 0, -12, 0, 0, -2, -14
"/home/jcfun/learning/Project/e-tech-assist/web-server/src/utils/email.rs", "Rust", 0, 0, 0, -36, 0, -3, -6, -45
"/home/jcfun/learning/Project/e-tech-assist/web-server/src/utils/epc.rs", "Rust", 0, 0, 0, -14, 0, -3, -4, -21
"/home/jcfun/learning/Project/e-tech-assist/web-server/src/utils/fields.rs", "Rust", 0, 0, 0, -82, 0, -15, -5, -102
"/home/jcfun/learning/Project/e-tech-assist/web-server/src/utils/ip.rs", "Rust", 0, 0, 0, -42, 0, 0, -5, -47
"/home/jcfun/learning/Project/e-tech-assist/web-server/src/utils/jwt.rs", "Rust", 0, 0, 0, -126, 0, -20, -14, -160
"/home/jcfun/learning/Project/e-tech-assist/web-server/src/utils/log.rs", "Rust", 0, 0, 0, -45, 0, -7, -6, -58
"/home/jcfun/learning/Project/e-tech-assist/web-server/src/utils/mod.rs", "Rust", 0, 0, 0, -14, 0, 0, -1, -15
"/home/jcfun/learning/Project/e-tech-assist/web-server/src/utils/permission.rs", "Rust", 0, 0, 0, -13, 0, 0, -2, -15
"/home/jcfun/learning/Project/e-tech-assist/web-server/src/utils/qrcode.rs", "Rust", 0, 0, 0, -9, 0, 0, -1, -10
"/home/jcfun/learning/Project/e-tech-assist/web-server/src/utils/redis.rs", "Rust", 0, 0, 0, -48, 0, -8, -8, -64
"/home/jcfun/learning/Project/e-tech-assist/web-server/src/utils/time.rs", "Rust", 0, 0, 0, -6, 0, -1, -2, -9
"/home/jcfun/learning/Project/e-tech-assist/web-server/src/utils/validate.rs", "Rust", 0, 0, 0, -38, 0, -1, -3, -42
"/home/jcfun/learning/Project/e-tech-assist/web-server/src/utils/wxapp.rs", "Rust", 0, 0, 0, -302, 0, -25, -27, -354
"Total", "-", 12162, 65, 14203, -5862, -66, -228, 1763, 22037